#########
#XXXSXXX#
#X#D#D#X#
#X#####X#
#XXXXXXD#
#X#X###E#
#X#XXXXX#
#########