########
#SXXXDX#
#XXXXXX#
#XDXXXX#
#XXXEXX#
#XXXXXX#
#XXDXDX#
########