#####
#SXX#
#XXX#
#XXE#
#####