#########
#SXX#XXE#
#XXXXXXX#
#XXX#XXX#
#########