######
#SXXX#
####X#
#EXXX#
######