#########
#S#X#X#X#
#X#XXX#X#
#XXX#XXX#
#X#X#X#E#
#########