#########
#SXXXXXX#
####X####
#XXXXXXE#
#########