#########
#SXXXXXD#
####X####
#XXXXXXE#
#########