############
#SXX#XX#XXX#
#XXXXXX#X#X#
#XXX#XXXX#E#
############