###########
#S#D#X#D#E#
#X#X#X#X#X#
#X#X#X#X#X#
#XXX#XXX#X#
#E#########