########
#SXXXXX#
#XXXXXX#
#XXXXXX#
#XXXEXX#
#XXXXXX#
#XXXXXX#
########